+--+--+--+--+--+--+--+
|        |           |
+  +--+  +  +--+--+  +
|  |  A     |     |  |
+  +  +--+  +  +  +  +
|     |     |  G  |  |
+--+  +  +--+  +--+  +
|  |     |     |     |
+  +--+  +  +--+  +  +
|     B  |        |  |
+  +--+--+  +--+  +  +
|              |     |
+--+--+--+--+--+--+--+
