+--+--+--+--+
|           |
+  +--+  +  +
|  |     | A|
+  +  +--+--+
|  |        |
+  +--+--+  +
| B      | G|
+--+--+--+--+
